0 0 0 0 0 0 0 0 0 0 0 0 0 0 0 0 0 0 0 0 0 0 0 0 0 0 0 0 0 0 0 0 0 0 0 0 0 0 0 0
0 0 5 0 0 0 0 0 0 0 0 0 0 0 0 0 0 0 0 0 0 0 0 0 0 0 0 0 0 0 0 0 0 0 0 0 0 0 0 0
1 2 2 3 0 4 0 4 0 0 5 5 5 0 0 0 0 0 0 0 0 0 5 0 0 0 0 0 0 0 0 0 0 0 0 0 0 0 0 0
0 0 0 0 0 0 0 0 0 1 2 2 2 2 3 0 0 0 0 0 1 2 2 2 3 0 0 0 0 0 0 1 2 3 0 5 0 0 0 0
0 0 0 0 4 0 4 0 4 0 0 0 0 0 0 0 4 0 4 0 0 0 0 0 0 0 5 0 1 3 0 0 0 0 1 2 3 0 0 4
1 2 2 3 0 0 0 0 0 0 0 0 0 1 2 3 0 0 0 0 0 0 0 0 1 2 3 0 0 0 0 0 0 0 0 0 0 0 4 0
0 0 0 0 0 0 0 0 0 0 0 0 4 0 0 0 0 0 5 5 0 0 4 0 0 0 0 4 0 0 0 0 0 0 0 0 0 4 0 0
0 0 0 0 0 0 0 0 0 1 2 3 0 0 0 1 2 2 2 2 3 0 0 0 0 0 0 0 1 2 3 0 0 1 2 2 3 0 0 0
0 0 0 0 0 0 0 0 4 0 0 0 0 0 0 0 0 0 0 0 0 0 0 0 0 4 0 0 0 0 0 4 0 0 0 0 0 0 0 0
1 2 3 0 0 4 0 0 0 0 0 0 0 1 3 0 1 2 3 0 1 2 2 3 0 0 1 3 0 0 0 0 0 4 0 0 0 5 5 5
0 0 0 0 0 0 0 0 0 0 0 0 4 0 0 0 0 0 0 0 0 0 0 0 0 0 0 0 0 0 1 2 3 0 0 1 2 2 2 3
0 0 0 0 0 1 2 3 0 0 0 4 0 0 0 0 1 2 2 3 0 0 0 1 2 2 2 2 3 0 0 0 0 0 0 0 0 0 0 0
1 3 0 0 0 0 0 0 0 5 0 0 0 0 0 4 0 0 0 0 0 0 5 0 0 0 0 0 0 0 5 5 0 0 0 0 0 0 0 0
0 0 4 0 0 0 0 1 2 2 2 3 0 4 0 0 0 0 0 0 1 2 2 3 0 0 0 1 2 3 5 5 5 5 0 0 0 0 0 0
0 0 0 0 0 4 0 0 0 0 0 0 0 0 1 2 3 0 0 0 0 0 0 0 0 5 0 0 0 0 1 2 2 2 3 0 0 1 2 3
0 0 5 0 0 0 1 2 2 2 3 0 0 0 0 0 0 0 0 4 0 0 0 0 1 2 2 3 0 0 0 0 0 0 0 0 4 0 0 0
1 2 2 2 3 0 0 0 0 0 0 0 0 0 0 0 0 4 0 0 0 5 5 0 0 0 0 0 0 0 4 0 0 5 5 0 0 0 0 0
0 0 0 0 0 4 0 0 0 1 2 2 2 2 2 3 0 0 0 1 2 2 2 2 2 2 2 2 2 3 0 0 1 2 2 2 2 2 2 3
0 0 0 5 0 0 0 1 3 0 0 0 0 0 0 0 0 0 0 0 0 0 0 0 0 0 0 0 0 0 0 0 0 0 0 0 0 0 0 0
1 2 2 2 2 2 3 0 0 0 0 0 0 0 0 0 0 0 0 0 0 0 0 0 0 0 0 0 0 0 0 0 0 0 0 0 0 0 0 0
